111111111111111111111111
1E0000100C00000C000000C1
101011011010100100010111
101011101100110100010101
1P000C0C00000000100000C1
111111111111111111111111