111111
10C101
1C01C1
1E0PC1
110111
11C111
111111