11111111111111
10C1000010C001
1CC100101001P1
10111110111101
1001000010C001
10000011110111
1001000C1C0001
11110110000101
1E0000C01C0101
11111111111111