NO ./wood.xpm
SO ./wood.xpm
WE ./wood.xpm
EA ./wood.xpm


C      147, 150, 148
F        65,     66,      65   




        11111111111    11111111111111 
        10000000001    10000000000001
        10110000011111110000000000001
        10010000000000000000000011111
111111111011000001110000000000001
100000000011000001110111111111111
11110101111111011100000010001
11110101111111011101010010001
11000000110111111101000010001
1000000000001 101001000000001
10000000000011101100010010001
110000N1010101011111111100011
1111011101110101 101111010001
1111111111111111 111111111111