NO ./textures/NO.xpm
SO ./textures/SO.xpm
WE ./textures/WE.xpm
EA ./textures/EA.xpm
F 220,100,0
C 225,30,0

        111111111111
        100000000001
11111111100000000001
10000000000000000001
10000000000100000001
10000N00000010000001
11111111111111111111