NO ./textures/NO.xpm
SO ./textures/SO.xpm
WE ./textures/WE.xpm
EA ./textures/EA.xpm

F 220,100,0
C 225,30,0

        1111111111
        1000000001
111111111000000001
100000000000S00001
100000N00000000001
111111111111111111