NO ./textures/NO.xpm
SO ./textures/SO.xpm
WE ./textures/WE.xpm
EA ./textures/EA.xpm

F 220,100,0

        1111111111
        1000000001
111111111000000001
100000000000000001
1N0000000000000001
111111111111111111