NO ./textures/NO.xpm
SO ./textures/SO.xpm
WE ./textures/WE.xpm
EA ./textures/EA.xpm
F 220,100,0
C 225,30,0

 111    1111111111
 101    1000000001
110111111000000001
100000000000000001
100000000000000001
111111111111111111