NO ./textures/NO.xpm
SO ./textures/SO.xpm
WE ./textures/WE.xpm
EA ./textures/EA.xpm
F 220,100,0
C 225,30,0

11011111111111111111
10000000000000000001
10000000000000000001
10000N00000000000001
11111111111111111111