NO ./textures/NO.xpm
SO ./textures/SO.xpm
WE ./textures/WE.xpm
EA ./textures/EA.xpm

F 220,100,0
C 225,30,0

11111111111111111111
100000000000000000011111111111111111111111111
100000000000000000000000010000000100000100001
100000000000000000011111010011100100101000N01
11000000000111111111   1000000010000100000001
 11100000111           1111111111111111111111
   1000001
   10000011111111111111111111111111111111111111111
   10000000000000000000000000000000000000000000001
   10111010010111010010100001110111011101001011101
   10101011010100010010100001010100010001101010101
   10101011010100010010100001010111010001101010101
   10111010110101010001000001100100010101011011101
   10101010010111011101000001010111011101001010101
   10000000000000000000000000000000000000000000001
   11111111111111111111111111111111111111111111111