NO ./textures/NO.xpm
SO ./textures/SO.xpm
WE ./textures/WE.xpm
EA ./textures/EA.xpm

F 220,100,0
C 225,30,0

11111111111111111111
100000000000000000011111111111111111111111111
100000000000000000000000000000000000000000001
10000N000000000000011111000000000000000000001
11000000000111111111   1000000000000000000001
 10000000001           1111111111111111111111
 11111111111