NO ./textures/NO.xpm
SO ./textures/SO.xpm
WE ./textures/WE.xpm
EA ./textures/EA.xpm

F 156,156,156
C 37,  40,  80

11111111111111111111
100000000000000000011111111111111111111111111
100000000000000000000000010000000100000100N01
100000000000000000011111010011100100101000001
11000000000111111111   1000000010000100000001
 11100000111           1111111111111111111111
   1000001
   1000001111111111111111111111111111111111111111
   1000000000000000000000000000000000000000000001
   1011101001011101001010001110111011101001011101
   1010101101010001001010001010100010001101010101
   1010101101010001001010001010111010001101010101
   1011101011010101000100001100100010101011011101
   1010101001011101110100001010111011101001010101
   1000000000000000000000000000000000000000000001
   1111111111111111111111111111111111111111111111