NO ./textures_aanghi/NO.xpm
SO ./textures_aanghi/SO.xpm
WE ./textures_aanghi/WE.xpm
EA ./textures_aanghi/EA.xpm

F 156,156,156
C 

        1111111111
111111111000000001
1S0000000000000001
111111111111111111
