NO ./textures_aanghi/NO.xpm
SO ./textures_aanghi/SO.xpm
WE ./textures_aanghi/WE.xpm
EA ./textures_aanghi/EA.xpm

F 220,100,0
C 225,30,0

        1111111111
111111111000000001
100000000000000001 S
111111111111111111
